*****
*S  *
* * *
* *G*
*****
