#########
#       #
#**S*** #
#     * #
# * *** #
# *   * #
# ******#
#   G   #
#########
