#########
#       #
#** *** #
#S    * #
# * *** #
# *   * #
# ******#
#      G#
#########
